Los Angeles Angels of Anaheim: LAA Angels,
KT Wiz Suwon : KT Wiz,
Kt Wiz       : KT Wiz,
Sk Wyverns   : SK Wyverns,
Lg Twins     : LG Twins,
Nc Dinos     : NC Dinos,
Hokkaido Nippon-Ham Fighters : Hokkaido Nippon Ham Fighters,
Yokohama Dena Baystars: Yokohama Bay Stars,
Connecticut Huskies : Connecticut,
South Florida Bulls : South Florida,
Duke Blue Devils    : Duke,
Mississippi St Bulldogs  : Mississippi St,
North Texas Mean Green : North Texas,
Southern Methodist Mustangs : SMU,
Ohio St Buckeyes : Ohio State,
Oklahoma Sooners : Oklahoma,
Notre Dame Fighting Irish : Notre Dame,
Georgia Bulldogs : Georgia,
Rice Owls : Rice,
Texas El Paso Miners : UTEP,
Lsu Tigers : LSU,
Chattanooga Mocs : Chattanooga,
New Mexico Lobos : New Mexico,
New Mexico St Aggies : New Mexico State,
Baylor Bears : Baylor,
Texas-San Antonio Roadrunners : Texas San Antonio,
Stanford Cardinals : Standford,
USC Trojans : USC,
Oregon St Beavers : Oregon State,
Minnesota Golden Gophers : Minnesota U,
Brigham Young Cougars : BYU,
Utah Utes : Utah,
Washington St Cougars : Washington State,
Boise State Broncos : Boise State,
Arizona Wildcats : Arizona U,
Houston Cougars : Housotn U,
Arizona St Sun Devils : Arizona State,
San Diego St Aztecs : San Diego State,
Michigan Wolverines : Michigan,
Cincinnati University : Cincinnati U,
Florida Atlantic Owls : Florida Atlantic,
Wisconsin Badgers : Wisconsin,
Iowa St Cyclones : Iowa State,
Iowa Hawkeyes : Iowa,
Army Black Knights : Army,
Buffalo Bulls : Buffalo U,
Kansas St Wildcats : Kansas State,
Charlotte 49ers : Charlotte,
North Carolina Tar Heels : North Carolina,
Louisville Cardinals : Louisville,
West Virginia Mountaineers : West Virginia,
East Carolina Pirates : East Carolina,
Boston College Eagles : Boston College,
Wake Forest Demon Deacons : Wake Forest,
Colorado Buffaloes : Colorado,
Texas State Bobcats : Texas State,
Ball St Cardinals : Ball State,
Alabama Birmingham Blazers : UAB,
Arkansas Razorbacks : Arkansas,
TCU Horned Frogs : TCU,
Middle Tennessee Blue Raiders : Middle Tenn State,
Syracuse Orange : Syracuse,
Navy Midshipmen : Navy,
Tulane Green Wave : Tulane,
Alabama Crimson Tide : Alabama,
Fresno State Bulldogs : Fresno State,
Rutgers Scarlet Knights : Rutgers,
Eastern Michigan Eagles : Eastern Michigan,
Virginia Cavaliers : Virginia,
Indiana Hoosiers : Indiana,
Michigan St Spartans : Michigan State,
Western Michigan Broncos : Western Michigan,
Massachusetts Minutemen : Massachusetts,
Penn St Nittany Lions : Penn State,
Pittsburgh Panthers : Pittsburgh U,
Tulsa Golden Hurricane : Tulsa,
UL Lafayette Ragin Cajuns : UL Lafayette,
Kansas Jayhawks : Kansas,
Central Michigan Chippewas : Central Michigan,
Oregon Ducks : Oregon,
Nebraska Cornhuskers : Nebraska,
Ucla Bruins : UCLA,
Hawaii Warriors : Hawaii,
Nevada Wolf Pack : Nevada,
Toledo Rockets : Toledo,
Clemson Tigers : Clemson,
Auburn Tigers : Auburn,
Idaho Vandals : Idaho,
Unlv Rebels : UNLV,
Missouri Tigers : Missouri,
South Carolina Gamecoks : South Carolina,
Purdue Boilermakers : Purdue,
Ohio Bobcats : Ohio,
South Alabama Jaguars : South Alabama,
Illinois Fighting Illini : Illinois,
Kentucky Hilltoppers : Western Kentucky,
Texas Longhorns : Texas,
Troy Trojans : Troy,
Marshall Thundering Herd : Marshall,
North Carolina St Wolfpack : NC State,
Mississippi Rebels : Mississippi,
California Golden Bears : California,
Texas Tech Red Raiders : Texas Tech,
Miami Ohio Red Hawks : Miami Ohio,
Bowling Green Falcons : Bowling Green,
Northwestern Wildcats : Northwestern,
Vanderbilt Commodores : Vanderbilt,
Georgia Tech Yellow Jackets : Georgia Tech,
UCF Knights : Central Florida,
Kentucky Wildcats : Kentucky,
Akron Zips : Akron,
Temple Owls : Temple,
Memphis Tigers : Memphis,
Air Force Falcons : Air Force,
Texas A&m : Texas A&&M,
Utah St Aggies : Utah State,
Florida Panthers : Florida Intl,
Tennessee Volunteers : Tennessee U,
Florida Gators : Florida,
Virginia Tech Hokies : Virginia Tech,
Kent St Golden Flashes : Kent State,
UL Monroe Warhawks : UL Monroe,
Colorado State Rams : Colorado State,
Appalachian State Mountaineers : Appalachian St,
Wyoming Cowboys : Wyoming,
Florida St Seminoles : Florida State,
Georgia State Panthers  : Georgia State,
Georgia Southern : Georgia Southern